0,0,0,0,0,0,0,0,0,1,0,0,0,0,1
0,0,0,0,0,0,0,0,0,1,10,3,0,0,1
0,0,0,0,0,0,0,0,0,1,1,1,0,0,1
0,0,0,0,0,0,0,0,0,0,0,0,0,0,1
0,0,0,0,0,0,0,0,0,0,0,0,0,0,1
0,3,0,0,0,0,0,3,12,0,0,0,0,0,1
0,1,0,0,11,0,0,1,0,0,3,3,0,0,1
0,0,0,0,1,0,0,0,0,0,1,1,0,0,1
4,4,4,4,4,4,4,4,4,4,1,1,5,5,1
1,1,1,1,1,1,1,1,1,1,1,1,1,1,1