1,1,1,1,1,1,1,1,1,1,1,1,1,1,1,1,1,1,1,1,1,1,1,1,1,1,1,1,1,1,1,1,1,1,1,1,1,1,1,1,1,1,1,1,1,1,1,1,1,1
1,0,0,0,0,0,0,0,0,0,0,0,0,3,0,0,0,0,0,0,0,0,0,0,0,1,3,3,3,1,3,3,3,3,0,0,0,0,3,3,3,3,3,3,0,0,0,0,7,1
1,6,0,0,0,0,0,0,0,0,0,0,0,3,0,0,0,0,0,0,0,0,0,0,0,1,3,1,3,1,3,3,3,3,0,0,0,0,3,3,3,3,3,3,0,0,0,1,1,1
1,1,1,1,0,0,0,0,0,0,0,0,0,3,0,0,0,0,0,0,0,0,0,0,0,1,3,1,3,1,3,3,3,3,0,0,0,0,3,3,3,3,3,3,0,1,1,1,1,1
1,1,1,1,3,3,3,0,0,0,0,0,0,3,1,1,0,0,0,0,0,0,0,0,0,1,3,1,3,1,3,3,3,3,0,0,0,0,0,0,0,0,0,0,0,1,1,1,1,1
1,1,1,1,3,3,3,0,0,0,0,0,0,3,1,1,1,0,0,0,0,0,0,0,0,1,3,1,3,1,3,3,3,3,0,0,0,0,0,0,0,0,0,0,0,1,1,1,1,1
1,1,1,1,1,1,1,1,1,0,0,0,0,0,1,1,1,1,0,0,0,0,0,0,0,1,3,1,3,1,1,1,1,1,0,0,0,0,0,0,0,0,0,0,0,1,1,1,1,1
1,1,1,1,1,1,1,1,1,0,0,0,1,0,1,1,1,1,1,0,0,0,0,0,0,0,0,1,3,0,0,0,0,0,0,0,0,0,0,0,0,0,0,0,4,1,1,1,1,1
1,1,1,1,1,1,1,1,1,4,4,4,1,5,1,1,1,1,1,1,0,0,0,0,0,0,0,1,3,0,0,0,0,0,11,0,0,1,5,5,5,5,5,5,1,1,1,1,1,1
1,1,1,1,1,1,1,1,1,1,1,1,1,1,1,1,1,1,1,1,1,1,1,1,1,1,5,1,1,1,1,1,1,1,1,1,1,1,1,1,1,1,1,1,1,1,1,1,1,1
